77767676767676767676767676767676777b0000000000000506070707070708000000000506070707070708000000000000000506070707070708000507070708000507070708000000000000000000000000000000000000000000000000000000000000000000000000000000000000000000000000000000000000000000
66675c5d5e5d5e5d5e5d5e5d5e5d5f4c676b0000000000001516171717171718000000001516171717171718000000000000001516171717171718001516171728002516171718000000000000000000000000000000000000000000000000000000000000000000000000000000000000000000000000000000000000000000
7b787c1f0f1f0f1f0f1f0f1f0f1f6f4d777b0000000000002526272727272718000000002526272727272718000000000000002526272727272718002526272728002526272718000000000000000000000000000000000000000000000000000000000000000000000000000000000000000000000000000000000000000000
66686c2f3f2f3f2f3f2f3f2f3f2f7f694c6b0000000000002526272727272718000000002526272727272721070708000507072026272727272718002526272721072026272718000000000000000000000000000000000000000000000000000000000000000000000000000000000000000000000000000000000000000000
787b7c1f0f1f0f1f0f1f0f1f0f1f6f794d7b0000000000002526272727272718000000002526272727272717171718001516171714272727272718001526272717171714272718000000000000000000000000000000000000000000000000000000000000000000000000000000000000000000000000000000000000000000
686b6c2f3f2f3f2f3f2f3f2f3f2f7f69694c0000000000002526272727272718000000002526272727272727272718002526272727272727272718002526272727272727272718000000000000000000000000000000000000000000000000000000000000000000000000000000000000000000000000000000000000000000
77787c1f0f1f0f1f0f1f0f1f0f1f6f79794d0000000000002526272727272718000000002526272727272727272718002526272727272727272718002526272727272727272718000000000000000000000000000000000000000000000000000000000000000000000000000000000000000000000000000000000000000000
67666c2f3f2f3f2f3f2f3f2f3f2f7f6969690000000000003537372223373738000000003537373622232436363738003537373622232436363738003537373622232436363738000000000000000000000000000000000000000000000000000000000000000000000000000000000000000000000000000000000000000000
787b7c1f0f1f0f1f0f1f0f1f0f1f6f7979790000000000000000003233000000000000000000000032333400000000000000000032333400000000000000000032333400000000000000000000000000000000000000000000000000000000000000000000000000000000000000000000000000000000000000000000000000
66676c2f3f2f3f2f3f2f3f2f3f2f7f6969690000000000000000000000000000000000000000000000000000000000000000000000000000000000000000000000000000000000000000000000000000000000000000000000000000000000000000000000000000000000000000000000000000000000000000000000000000
7b777c1f0f1f0f1f0f1f0f1f0f1f6f7979790000000000000000000000000000000000000000000000000000000000000000000000000000000000000000000000000000000000000000000000000000000000000000000000000000000000000000000000000000000000000000000000000000000000000000000000000000
6b686c2f3f2f3f2f3f2f3f2f3f2f7f6969690000000000000000000000000000000000000000050607070800000000000000000000000000000000000000000000000000000000000000000000000000000000000000000000000000000000000000000000000000000000000000000000000000000000000000000000000000
7b786d7d7e7d7e7d7e7d7e7d7e7d6e7979790000000000000000000000000000000000000000151617171800000000000000000000000000000000000000000000000000000000000000000000000000000000000000000000000000000000000000000000000000000000000000000000000000000000000000000000000000
67666a6969696969696969696969696969690000000000000000000000000000000000000000252627271800000000000000000000000000000000000000000000000000000000000000000000000000000000000000000000000000000000000000000000000000000000000000000000000000000000000000000000000000
7b4e7a7979797979797979797979797979790000000000000000000000000000000000050607032627271800000000000000000000000000000000000000000000000000000000000000000000000000000000000000000000000000000000000000000000000000000000000000000000000000000000000000000000000000
686b676a69696969696969696969696969690000000000000000000000000000000000151617172427271800000000000000000000000000000000000000000000000000000000000000000000000000000000000000000000000000000000000000000000000000000000000000000000000000000000000000000000000000
4e784e7a79797979797979797979797979790000000000000000000000000000000000252627272727271800000000000000000000000000000000000000000000000000000000000000000000000000000000000000000000000000000000000000000000000000000000000000000000000000000000000000000000000000
0000000000000000000000000000000000000000000000000000000000000000000000152627272727271800000000000000000000000000000000000000000000000000000000000000000000000000000000000000000000000000000000000000000000000000000000000000000000000000000000000000000000000000
0000000000000000000000000000000000000000000000000000000000000000000000252627272727272800000000000000000000000000000000000000000000000000000000000000000000000000000000000000000000000000000000000000000000000000000000000000000000000000000000000000000000000000
0000000000000000000000000000000000000000000000000000000000000000000000252627272727271800000000000000000000000000000000000000000000000000000000000000000000000000000000000000000000000000000000000000000000000000000000000000000000000000000000000000000000000000
0000000000000000000000000000000000000000000000000000000000000000000000252627272727271800000000000000000000000000000000000000000000000000000000000000000000000000000000000000000000000000000000000000000000000000000000000000000000000000000000000000000000000000
00000000000000000000000000000000000000000000000000000000000000000000003537372b2c37373800000000000000000000000000000000000000000000000000000000000000000000000000000000000000000000000000000000000000000000000000000000000000000000000000000000000000000000000000
00000000000000000000000000000000000000000000000000000000000000000000000000003b3c00000000000000000000000000000000000000000000000000000000000000000000000000000000000000000000000000000000000000000000000000000000000000000000000000000000000000000000000000000000